###########################################################
#A                                                        #
# ### # ####### # ####### # ####### # ####### # ####### # #
#   # #   #   # #   #   # #   #   # #   #   # #   #   #   #
# # # # # # # # # # # # # # # # # # # # # # # # # # # # # #
# # #   # # # # # # # # # # # # # # # # # # # # # # # # # #
# # ##### # # # # # # # # # # # # # # # # # # # # # ##### #
# #     # # # #   # # # #   # # # #   # # # #   #       # #
# ##### # # # ##### # # ##### # # ##### # # ##### ##### # #
#     # #   #     # #   #   # #   #   # #   #   #     # # #
# ### # ##### ### # ##### # # ##### # # ##### # # ### # # #
#   # #     #   # #     # #   #   # #   #   # # #   # #   #
### # ##### # # # ##### # ##### # # ##### # # # # # # ### #
#   #     # # # #     # #     # # #     # # # # # # #   # #
# ####### # # # ##### # ##### # # ##### # # # # # # ### # #
#       # # # #     #   #   # # #     # # # # # # #   # # #
# ##### # # # ##### ##### # # # ##### # # # # # # # # # # #
#     # # # #     #     # #   #     # #   # # # # # # #   #
##### # # # ##### # ### # ##### ### # ##### # # # # # ### #
#   # #   #     # #   # #     #   # #     # # # # # #   # #
# # # ##### ### # # # # ##### # # # ##### # # # # # # # # #
# # #     #   # # # # #     # # # #     # # # # # # # # # #
# # ##### # # # # # # ##### # # # ##### # # # # # # # # # #
# #     # # # #   # #     # #   #     # #   # # # #   #   #
# ##### # # # ##### ##### # ##### ### # ##### # # ##### ###
#     # # # #     #     # #     #   # #     # # #     #   #
##### # # # ##### # ### # ##### # # # ##### # # ##### # # #
#   # #   #     # #   # #     # # # #     # #   #   # # # #
# # # ##### ### # # # # ##### # # # ##### # ### # # # # # #
# # #     #   # # # # #     # # # #     # #   # # # # # # #
# # ##### # # # # # # ##### # # # ##### # # # # # # # # # #
# #     # # # # # # #     # # # #     # # # # # #   # #   #
# ##### # # # # # # ##### # # # ##### # # # # # ##### ### #
#     # # # # # # #     # # # #     # # # # # #     #   # #
##### # # # # # # ##### # # # ##### # # # # # ##### # # # #
#   #   # # #   #     #   # #     # #   # # #     # # #   #
# # ##### # ##### ########### ##### ##### # ##### # # ### #
# #     # #     #           #     #     # #     # # #   # #
# ##### # ##### ########### ##### ##### # ##### # # # # # #
#     # #     #           #     #     # #     # # # # #   #
##### # ##### ########### ##### ##### # ##### # # # ##### #
#   # #     #           #     #     # #     # # # #     # #
# # # ##### ########### ##### ##### # ##### # # # ##### # #
# # #     #           #     #     # #     # # # #     #   #
# # ##### ########### ##### ##### # ##### # # # ##### #####
# #                 #           #       # # # #           B
###########################################################