###############
#A    #       #
##### # ##### #
#     #     # #
# ######### # #
#           #B#
###############