###############################################################
#A    #     #         #         #         #         #         #
##### # ### # ####### # ####### # ####### # ####### # ####### #
#   #   #   #       #   #     #   #     #   #     #   #     # #
# # ##### ######### ##### ### ##### ### ##### ### ##### ### # #
# #     #         #     # #       # #       # #       # #   # #
# ##### ######### ##### # ####### # ####### # ####### # # ### #
#     #         #     # #       # #       # #       # # #   # #
##### ####### # ##### # ##### # # ##### # # ##### # # ### # # #
#   #       # #     # #     # # #     # # #     # # #   # # # #
# # ####### # ##### # ##### # # ##### # # ##### # # # # # # # #
# #       # #     # #     # # #     # # #     # # # # # # # # #
# ####### # ##### # ##### # # ##### # # ##### # # # # # # # # #
#       # #     # #     # # #     # # #     # # # # # #   # # #
####### # ##### # ##### # # ##### # # ##### # # # # # ### # # #
#     # #     # #     # # #     # # #     # # # # # #   # # # #
# ### # ##### # ##### # # ##### # # ##### # # # # # ### # # # #
# #   #     # #     # # #     # # #     # # # # # #   # #   # #
# # ####### # ##### # # ##### # # ##### # # # # # ### # ### # #
# #       # #     # # #     # # #     # # #   # #   # #   # # #
# ####### # ##### # # ##### # # ##### # # ### # ### # ### # # #
#       # #     # # #     # # #     # #   #   #   # #   # # # #
####### # ##### # # ##### # # ##### # ### ### ### # ### # # # #
#     # #     # # #     # # #     # #   #   #   # #   # #   # #
# ### # ##### # # ##### # # ##### # ### ### ### # ### # ### # #
# #   #     # # #     # # #     # #   #   #   # #   # #   # # #
# # ####### # # ##### # # ##### # ### ### ### # ### # ### # # #
# #       # # #     # # #     # #   #   #   # #   # #   # # # #
# ####### # # ##### # # ##### # ### ### ### # ### # ### # # # #
#       # # #     # #   #     #   #   #   # #   # #   # #   # #
####### # # ##### # ##### ####### ### ### # ### # ### # ### # #
#       #       #               #         #     #     #     #B#
###############################################################