########################################################################################################################################################
#A                                                                                                                                                     #
# ### # ####### # ####### # ####### # ####### # ####### # ####### # ####### # ####### # ####### # ####### # ####### # ####### # ####### # ####### #    #
#   # #   #   # #   #   # #   #   # #   #   # #   #   # #   #   # #   #   # #   #   # #   #   # #   #   # #   #   # #   #   # #   #   # #   #   #      #
# # # # # # # # # # # # # # # # # # # # # # # # # # # # # # # # # # # # # # # # # # # # # # # # # # # # # # # # # # # # # # # # # # # # # # # # # # #  #
# # #   # # # # # # # # # # # # # # # # # # # # # # # # # # # # # # # # # # # # # # # # # # # # # # # # # # # # # # # # # # # # # # # # # # # # # # #  #
# # ##### # # # # # # # # # # # # # # # # # # # # # # # # # # # # # # # # # # # # # # # # # # # # # # # # # # # # # # # # # # # # # # # # # # # #####  #
# #     # # # #   # # # #   # # # #   # # # #   # # # #   # # # #   # # # #   # # # #   # # # #   # # # #   # # # #   # # # #   # # # #   #       # #  #
# ##### # # # ##### # # ##### # # ##### # # ##### # # ##### # # ##### # # ##### # # ##### # # ##### # # ##### # # ##### # # ##### # # ##### ##### # #  #
#     # #   #     # #   #   # #   #   # #   #   # #   #   # #   #   # #   #   # #   #   # #   #   # #   #   # #   #   # #   #   # #   #   #     # #    #
# ### # ##### ### # ##### # # ##### # # ##### # # ##### # # ##### # # ##### # # ##### # # ##### # # ##### # # ##### # # ##### # # ##### # # ### # # #  #
#   # #     #   # #     # #   #   # #   #   # # #   # # #   #   # # #   # # #   #   # # #   # # #   #   # # #   # # #   #   # # #   # # # #   # #      #
### # ##### # # # ##### # ##### # # ##### # # # # # # # ##### # # # # # # # ##### # # # # # # # ##### # # # # # # # ##### # # # # # # # # # # # # ###  #
#   #     # # # #     # #     # # #     # # # # # # # #     # # # # # # # #     # # # # # # # #     # # # # # # # #     # # # # # # # # # # # # #   #  #
# ####### # # # ##### # ##### # # ##### # # # # # # # ##### # # # # # # # ##### # # # # # # # ##### # # # # # # # ##### # # # # # # # # # # # # ### #  #
#       # # # #     #   #   # # #     # # # # # # # #     # # # # # # # #     # # # # # # # #     # # # # # # # #     # # # # # # # # # # # # #   # #  #
# ##### # # # ##### ##### # # # ##### # # # # # # # ##### # # # # # # # ##### # # # # # # # ##### # # # # # # # ##### # # # # # # # # # # # # # # # #  #
#     # # # #     #     # #   #     # #   # # # # #     # #   # # # # #     # #   # # # # #     # #   # # # # #     # #   # # # # # # # # # # # # #    #
##### # # # ##### # ### # ##### ### # ##### # # # ##### # ##### # # # ##### # ##### # # # ##### # ##### # # # ##### # ##### # # # # # # # # # # # ###  #
#   # #   #     # #   # #     #   # #     # # # #     # #     # # # #     # #     # # # #     # #     # # # #     # #     # # # # # # # # # # # #   #  #
# # # ##### ### # # # # ##### # # # ##### # # # ##### # ##### # # # ##### # ##### # # # ##### # ##### # # # ##### # ##### # # # # # # # # # # # # # #  #
# # #     #   # # # # #     # # # #     # # # #     # # #   # # # #     # #     # # # #     # #     # # # #     # #     # # # # # # # # # # # # # # #  #
# # ##### # # # # # # ##### # # # ##### # # # ##### # # # # # # # ##### # ##### # # # ##### # ##### # # # ##### # ##### # # # # # # # # # # # # # # #  #
# #     # # # #   # #     # #   #     # #   # #   # # # # # # # #     # #     # #   #     # #     # #   # #   # #     # #   # # # # # # # # # #   #    #
# ##### # # # ##### ##### # ##### ### # ##### # # # # # # # # # ##### # ##### # ##### ### # ##### # ##### # # # ##### # ##### # # # # # # # # ##### ## #
#     # # # #     #     # #     #   # #     # # # # # # # # # #     # #     # #     #   # #     # #     # # # #     # #     # # # # # # # # # #     #  #
##### # # # ##### # ### # ##### # # # ##### # # # # # # # # # ##### # ##### # ##### # # # ##### # ##### # # # ##### # ##### # # # # # # # # # ##### # ##
#   # #   #     # #   # #     # # # #     # #   # # # # # # #     # #     # #     # # # #     # #     # # # #     # #     # #   # # # # # # #     # # ##
# # # ##### ### # # # # ##### # # # ##### # ### # # # # # # ##### # ##### # ##### # # # ##### # ##### # # # ##### # ##### # ### # # # # # # ##### # # ##
# # #     #   # # # # #     # # # #     # #   # # # # # # #     # #     # #     # # # #     # #     # # # #     # #     # #   # # # # # # #     # # # ##
# # ##### # # # # # # ##### # # # ##### # # # # # # # # # ##### # ##### # ##### # # # ##### # ##### # # # ##### # ##### # # # # # # # # # ##### # # # ##
# #     # # # # # # #     # # # #     # # # # # #   # # #     # #     # #     # # # #     # #     # # # #     # #     # # # # # # #   # #     # #   #  #
# ##### # # # # # # ##### # # # ##### # # # # # ##### # ##### # ##### # ##### # # # ##### # ##### # # # ##### # ##### # # # # # # ##### ##### # ### ####
#     # # # # # # #     # # # #     # # # # # #     # #     # #     # #     # # # #     # #     # # # #     # #     # # # # # # #     #     # #   #   ##
##### # # # # # # ##### # # # ##### # # # # # ##### # ##### # ##### # ##### # # # ##### # ##### # # # ##### # ##### # # # # # # ##### ##### # # # # # ##
#   #   # # #   #     #   # #     # #   # # #     # #     # #     # #     # #   #     # #     # #   #     # #     # #   # # # #     #     # # # # # #  #
# # ##### # ##### ########### ##### ##### # ##### # ##### # ##### # ##### # ##### ##### ##### # ##### ##### ##### # ##### # # ##### ##### # # # # # ####
# #     # #     #           #     #     # #     # #     # #     # #     # #     #     #     # #     #     #     # #     # # #     #     # # # # # #   ##
# ##### # ##### ########### ##### ##### # ##### # ##### # ##### # ##### # ##### ##### ##### # ##### ##### ##### # ##### # # ##### ##### # # # # # # # ##
#     # #     #           #     #     # #     # #     # #     # #     # #     #     #     # #     #     #     # #     # # #     #     # # # # #   # #  #
##### # ##### ########### ##### ##### # ##### # ##### # ##### # ##### # ##### ##### ##### # ##### ##### ##### # ##### # # ##### ##### # # # # ##### ####
#   # #     #           #     #     # #     # #     # #     # #     # #     #     #     # #     #     #     # #     # # #     #     # # # # #     #   ##
# # # ##### ########### ##### ##### # ##### # ##### # ##### # ##### # ##### ##### ##### # ##### ##### ##### # ##### # # ##### ##### # # # # ##### # # ##
# # #     #           #     #     # #     # #     # #     # #     # #     #     #     # #     #     #     # #     # # #     #     # # # # #     # # # ##
# # ##### ########### ##### ##### # ##### # ##### # ##### # ##### # ##### ##### ##### # ##### ##### ##### # ##### # # ##### ##### # # # # ##### # # # ##
# #     #           #     #     # #     # #     # #     # #     # #     #     #     # #     #     #     # #     # # #     #     # # # # #     # # #   ##
# ##### ########### ##### ##### # ##### # ##### # ##### # ##### # ##### ##### ##### # ##### ##### ##### # ##### # # ##### ##### # # # # ##### # # ### ##
# #   #           #     #     # #     # #     # #     # #     # #     #     #     # #     #     #     # #     # # #     #     # # # # #     # # #   # ##
# # # ########### ##### ##### # ##### # ##### # ##### # ##### # ##### ##### ##### # ##### ##### ##### # ##### # # ##### ##### # # # # ##### # # # # # ##
# # #           #     #     # #     # #     # #     # #     # #     #     #     # #     #     #     # #     # #   #   #     # # # # #     # # # # #   ##
# # ########### ##### ##### # ##### # ##### # ##### # ##### # ##### ##### ##### # ##### ##### ##### # ##### # ### # # ##### # # # # ##### # # # # ### ##
# #           #     #     # #     # #     # #     # #     # #     #     #     # #     #     #     # #     # #   # # #     # # # # #     # # # # #   # ##
# ########### ##### ##### # ##### # ##### # ##### # ##### # ##### ##### ##### # ##### ##### ##### # ##### # # # # # ##### # # # # ##### # # # # # # # ##
#           #     #     # #     # #     # #     # #     # #     #     #     # #     #     #     # #     # # # # # #     # # # # #     # # # # # # #   ##
########### ##### ##### # ##### # ##### # ##### # ##### # ##### ##### ##### # ##### ##### ##### # ##### # # # # # ##### # # # # ##### # # # # # # ### ##
#         #     #     # #     # #     # #     # #     # #     #     #     # #     #     #     # #     # # # # # #     # # # # #     # # # # # # #   #  #
# ####### ##### ##### # ##### # ##### # ##### # ##### # ##### ##### ##### # ##### ##### ##### # ##### # # # # # ##### # # # # ##### # # # # # # # # ####
#       #     #     # #     # #     # #     # #     # #     #     #     # #     #     #     # #     # # # # # #     # # # # #     # # # # # # # # #   ##
####### ##### ##### # ##### # ##### # ##### # ##### # ##### ##### ##### # ##### ##### ##### # ##### # # # # # ##### # # # # ##### # # # # # # # # # # ##
#     #     #     # #     # #     # #     # #     # #     #     #     # #     #     #     # #     # # # #   #     # # # # #     # # # # # # # # # # #  #
##### ##### ##### # ##### # ##### # ##### # ##### # ##### ##### ##### # ##### ##### ##### # ##### # # # ##### ##### # # # ##### # # # # # # # # # # ####
#   #     #     # #     # #     # #     # #     # #     #     #     # #     #     #     # #     # #   #     #     # # # #     # # # # # # # # # # #   ##
# # ##### ##### # ##### # ##### # ##### # ##### # ##### ##### ##### # ##### ##### ##### # ##### # ##### ##### ##### # # ##### # # # # # # # # # # # # ##
# #     #     # #     # #     # #     # #     # #     #     #     # #     #     #     # #     # #     #     #     # # #     # # # # # # # # # # # # # ##
# ##### ##### # ##### # ##### # ##### # ##### # ##### ##### ##### # ##### ##### ##### # ##### # ##### ##### ##### # # ##### # # # # # # # # # # # # # ##
#     #     # #     # #     # #     # #     # #     #     #     # #     #     #     # #     # #     #     #     # # #     # # # # # # # # # # # #   #  #
##### ##### # ##### # ##### # ##### # ##### # ##### ##### ##### # ##### ##### ##### # ##### # ##### ##### ##### # # ##### # # # # # # # # # # # ##### ##
#   #     # #     # #     # #     # #     # #     #     #     # #     #     #     # #     # #     #     #     # # #     # # # # # # # # # # # #     #  #
# # ##### # ##### # ##### # ##### # ##### # ##### ##### ##### # ##### ##### ##### # ##### # ##### ##### ##### # # ##### # # # # # # # # # # # ##### # ##
# #     # #     # #     # #     # #     # #     #     #     # #     #     #     # #     # #     #     #     # #   #   # # # # # # # # # # # #     # # ##
# ##### # ##### # ##### # ##### # ##### # ##### ##### ##### # ##### ##### ##### # ##### # ##### ##### ##### # ### # # # # # # # # # # # # # ##### # # ##
# #   # #     # #     # #     # #     # #     #     #     # #     #     #     # #     # #     #     #     # #   # # # # # # # # # # # # # #     # # # ##
# # # # ##### # ##### # ##### # ##### # ##### ##### ##### # ##### ##### ##### # ##### # ##### ##### ##### # # # # # # # # # # # # # # # # ##### # # # ##
# # # #     # #     # #     # #     # #     #     #     # #     #     #     # #     # #     #     #     # # # # # # # # # # # # # # # # #     # # #   ##
# # # ##### # ##### # ##### # ##### # ##### ##### ##### # ##### ##### ##### # ##### # ##### ##### ##### # # # # # # # # # # # # # # # # ##### # # ### ##
# # #     # #     # #     # #     # #     #     #     # #     #     #     # #     # #     #     #     # # # # # # # # # # # # # # # # #     # # #   # ##
# # ##### # ##### # ##### # ##### # ##### ##### ##### # ##### ##### ##### # ##### # ##### ##### ##### # # # # # # # # # # # # # # # # ##### # # # # # ##
# #     # #     # #     # #     # #     #     #     # #     #     #     # #     # #     #     #     # # # # # #   # # # # # # # # # #     # # # # #   ##
# ##### # ##### # ##### # ##### # ##### ##### ##### # ##### ##### ##### # ##### # ##### ##### ##### # # # # # ### # # # # # # # # # ##### # # # # ### ##
# #   # #     # #     # #     # #     #     #     # #     #     #     # #     # #     #     #     # # # # # #   # # # # # # # # # #     # # # # #   # ##
# # # # ##### # ##### # ##### # ##### ##### ##### # ##### ##### ##### # ##### # ##### ##### ##### # # # # # # # # # # # # # # # # ##### # # # # # # # ##
# # # #     # #     # #     # #     #     #     # #     #     #     # #     # #     #     #     # # # # # # # # # # # # # # # # #     # # # # # # #   ##
# # # ##### # ##### # ##### # ##### ##### ##### # ##### ##### ##### # ##### # ##### ##### ##### # # # # # # # # # # # # # # # # ##### # # # # # # ### ##
# # #     # #     # #     # #     #     #     # #     #     #     # #     # #     #     #     # # # # # # # # # # # # # # # # #     # # # # # # #   #  #
# # ##### # ##### # ##### # ##### ##### ##### # ##### ##### ##### # ##### # ##### ##### ##### # # # # # # # # # # # # # # # # ##### # # # # # # # # ####
# #                                                                                                                                 # # # #           B#
########################################################################################################################################################